111111111111111111111111
100000010000000100000001      
100000010000000100000001
100000010000000100000001
100000010000000100000001
100000010000000100000001
100000010000000100000001
100000010000000100000001
111111011110111111101111
100001000000000000000000
100001000000000000000000
100000000000000000000000
100001000000000111000111
100001000000000100000001
111111000000000100000001
100001001111100100000001
100001001010100100000001
100000000010000100000001
100001001010100100000001
100001001111100100000001
111111001010100100000001
100010000010000100000001
100000001010100100000001
100010001111100100000001
111110001010100100000001
100010000010000100000001
100000001010100100000001
100010001111100100000001
111110000000000100000001
100010000000000100000001
100000000000000100000001
100010000000000100000001
111100000000000100000001
1
1
1
1
1
1
































0
